1122221111
3        1
2        3
2        1
1       11
12222    1
1       11
1     2111
1       11
1133331111