11122221111
1         1
3         1
1         3
1         3
1    1    1
1    1    1
1    2    1
1    1    1
11122111311